tilesetIso.png 7 36 80
15 15
1 2 1 1 0 2 4 4 4 5 5 5 5 5 5
1 1 1 1 0 0 0 4 4 4 5 5 5 5 5
1 1 1 1 1 1 0 0 4 4 5 5 5 5 5
3 1 1 1 1 1 0 0 4 4 4 4 5 5 5
3 3 1 1 1 2 1 0 0 4 4 4 4 5 5
3 1 1 1 1 1 1 0 0 0 0 4 4 4 4
1 1 1 1 1 1 1 1 1 0 0 0 0 4 4
1 1 1 1 1 1 1 6 1 1 1 0 0 0 0
2 1 1 1 1 1 1 1 1 1 1 1 1 0 0
1 1 1 1 1 1 1 1 1 1 1 1 1 1 1
1 1 1 1 1 1 1 1 1 1 1 1 1 1 1
1 1 1 1 1 1 1 1 1 1 1 2 1 1 1
1 1 3 3 3 1 1 1 1 2 1 1 1 1 1
1 3 3 3 1 1 1 2 1 1 1 1 1 1 1
1 1 1 1 1 1 1 1 1 1 1 1 1 1 1
0 1 2 -1
cogumelo.png
4
0 0 
1 1 
2 2
3 3