TileSet.png 5 57 114
15 15
1 0 0 0 0 0 0 0 3 3 3 3 3 3 3
0 3 0 0 0 3 0 0 1 1 3 3 3 3 3
0 0 0 0 0 0 0 0 0 0 1 1 3 3 3
0 0 0 0 4 4 4 4 0 0 0 1 1 1 3
0 4 4 4 4 4 4 4 0 0 0 0 0 1 1
4 4 4 4 4 4 4 4 2 2 2 2 2 2 2
2 2 2 2 2 2 2 2 2 2 2 2 2 2 2
2 2 2 2 2 2 2 2 2 2 2 2 2 2 2
2 2 2 2 2 2 2 2 2 2 2 2 2 2 2
2 2 2 2 2 2 2 2 2 2 2 2 2 2 2
2 2 2 2 2 2 2 2 2 2 2 2 2 2 2
2 2 2 2 2 2 2 2 2 2 2 2 2 2 2
2 2 2 2 2 2 2 2 2 2 2 2 2 2 2
4 4 4 4 4 4 4 2 2 2 2 2 2 2 2
4 4 4 4 4 4 4 4 2 2 2 2 2 2 2
0 1 2 -1
cogumelo.png
0 0 
1 1 
2 2
3 3